{
  "Test": {
    "meta" : {
      "name" : "Test",
      "author" : "DolphInspired",
      "created" : "01/25/2016 11:22:33.444",
      "modified" : "01/25/2016 11:22:33.444",
      "size" : 8
    },
    "1" : {
      "name" : "Test 00",
      "password" : "AAAA",
      "time" : 0,
      "chips" : 0,
      "hint" : "First functional level created. Tests drawing and simple collision. The teleports came MUCH later...",
      "links" : {

      },
      "width" : 9,
      "board" : [
        1, 1, 1, 1, 1, 1, 1, 1, 1,
        1, 6300, 0, 0, 0, 0, 0, 0, 1,
        1, 0, 42, 0, 0, 0, 42, 0, 1,
        1, 0, 0, 0, 0, 0, 0, 0, 1,
        1, 0, 0, 0, 12000000, 0, 0, 0, 1,
        1, 0, 0, 0, 0, 0, 0, 0, 1,
        1, 0, 42, 0, 40, 0, 42, 0, 1,
        1, 0, 0, 0, 0, 0, 0, 7, 1,
        1, 1, 1, 1, 1, 1, 1, 1, 1
      ]
    },
    "2" : {
      "name" : "Test 01",
      "password" : "DBCA",
      "time" : 120,
      "chips" : 12,
      "hint" : "This level tests lots of things, including level scrolling. Some things don't work yet...",
      "links" : {

      },
      "width" : 12,
      "board" : [
        1, 1, 1, 1, 1, 1, 1, 1, 1, 1, 1, 1,
        1, 12000000, 6300, 6300, 63, 63, 0, 0, 0, 0, 0, 1,
        1, 0, 0, 0, 0, 0, 0, 0, 0, 1100, 31, 1,
        1, 40, 6000, 6000, 60, 60, 0, 0, 0, 0, 0, 1,
        1, 0, 0, 0, 0, 35, 0, 0, 0, 1000, 30, 1,
        1, 0, 6100, 6100, 61, 61, 0, 0, 0, 0, 0, 1,
        1, 0, 0, 0, 0, 0, 0, 0, 0, 1300, 20, 1,
        1, 0, 6200, 6200, 62, 62, 0, 0, 0, 0, 0, 1,
        1, 0, 0, 0, 0, 0, 0, 0, 0, 1200, 32, 1,
        1, 100, 100, 100, 100, 100, 100, 100, 100, 100, 6, 1,
        1, 420000, 100, 100, 100, 100, 100, 100, 100, 6, 7, 1,
        1, 1, 1, 1, 1, 1, 1, 1, 1, 1, 1, 1
      ]
    },
    "3" : {
      "name" : "Test 02",
      "password" : "ABCD",
      "time" : 0,
      "chips" : 0,
      "hint" : "Thin wall collision test. Could you tell?",
      "links" : {

      },
      "width" : 9,
      "board" : [
        1, 1, 1, 1, 1, 1, 1, 1, 1,
        1, 7, 0, 0, 0, 0, 0, 40, 1,
        1, 0, 0, 0, 0, 0, 0, 0, 1,
        1, 0, 0, 15, 10, 14, 0, 0, 1,
        1, 0, 0, 11, 12000000, 0, 13, 0, 1,
        1, 0, 0, 16, 12, 17, 0, 0, 1,
        1, 0, 0, 0, 0, 0, 0, 0, 1,
        1, 0, 0, 0, 0, 0, 0, 0, 1,
        1, 1, 1, 1, 1, 1, 1, 1, 1
      ]
    },
    "4" : {
      "name" : "LESSON 1",
      "password" : "BDHP",
      "time" : 100,
      "chips" : 11,
      "hint" : "Hint: collect chips to get past the chip socket. Use keys to open doors.",
      "links" : {

      },
      "width" : 32,
      "board" : [
        0, 0, 0, 0, 0, 0, 0, 0, 0, 0, 0, 0, 0, 0, 0, 0, 0, 0, 0, 0, 0, 0, 0, 0, 0, 0, 0, 0, 0, 0, 0, 0,
        0, 0, 0, 0, 0, 0, 0, 0, 0, 0, 0, 0, 0, 0, 0, 0, 0, 0, 0, 0, 0, 0, 0, 0, 0, 0, 0, 0, 0, 0, 0, 0,
        0, 0, 0, 0, 0, 0, 0, 0, 0, 0, 0, 0, 0, 0, 0, 0, 0, 0, 0, 0, 0, 0, 0, 0, 0, 0, 0, 0, 0, 0, 0, 0,
        0, 0, 0, 0, 0, 0, 0, 0, 0, 0, 0, 0, 0, 0, 0, 0, 0, 0, 0, 0, 0, 0, 0, 0, 0, 0, 0, 0, 0, 0, 0, 0,
        0, 0, 0, 0, 0, 0, 0, 0, 0, 0, 0, 0, 0, 0, 0, 0, 0, 0, 0, 0, 0, 0, 0, 0, 0, 0, 0, 0, 0, 0, 0, 0,
        0, 0, 0, 0, 0, 0, 0, 0, 0, 0, 0, 0, 0, 0, 0, 0, 0, 0, 0, 0, 0, 0, 0, 0, 0, 0, 0, 0, 0, 0, 0, 0,
        0, 0, 0, 0, 0, 0, 0, 0, 0, 0, 0, 0, 0, 0, 0, 0, 0, 0, 0, 0, 0, 0, 0, 0, 0, 0, 0, 0, 0, 0, 0, 0,
        0, 0, 0, 0, 0, 0, 0, 0, 0, 0, 0, 0, 0, 0, 0, 0, 0, 0, 0, 0, 0, 0, 0, 0, 0, 0, 0, 0, 0, 0, 0, 0,
        0, 0, 0, 0, 0, 0, 0, 0, 0, 0, 1, 1, 1, 1, 1, 0, 1, 1, 1, 1, 1, 0, 0, 0, 0, 0, 0, 0, 0, 0, 0, 0,
        0, 0, 0, 0, 0, 0, 0, 0, 0, 0, 1, 0, 0, 0, 1, 1, 1, 0, 0, 0, 1, 0, 0, 0, 0, 0, 0, 0, 0, 0, 0, 0,
        0, 0, 0, 0, 0, 0, 0, 0, 0, 0, 1, 0, 100, 0, 1, 7, 1, 0, 100, 0, 1, 0, 0, 0, 0, 0, 0, 0, 0, 0, 0, 0,
        0, 0, 0, 0, 0, 0, 0, 0, 1, 1, 1, 1, 1, 63, 1, 6, 1, 63, 1, 1, 1, 1, 1, 0, 0, 0, 0, 0, 0, 0, 0, 0,
        0, 0, 0, 0, 0, 0, 0, 0, 1, 0, 6200, 0, 60, 0, 0, 0, 0, 0, 61, 0, 6200, 0, 1, 0, 0, 0, 0, 0, 0, 0, 0, 0,
        0, 0, 0, 0, 0, 0, 0, 0, 1, 0, 100, 0, 1, 6000, 0, 40, 0, 6100, 1, 0, 100, 0, 1, 0, 0, 0, 0, 0, 0, 0, 0, 0,
        0, 0, 0, 0, 0, 0, 0, 0, 1, 1, 1, 1, 1, 100, 0, 12000000, 0, 100, 1, 1, 1, 1, 1, 0, 0, 0, 0, 0, 0, 0, 0, 0,
        0, 0, 0, 0, 0, 0, 0, 0, 1, 0, 100, 0, 1, 6000, 0, 0, 0, 6100, 1, 0, 100, 0, 1, 0, 0, 0, 0, 0, 0, 0, 0, 0,
        0, 0, 0, 0, 0, 0, 0, 0, 1, 0, 0, 0, 61, 0, 0, 100, 0, 0, 60, 0, 0, 0, 1, 0, 0, 0, 0, 0, 0, 0, 0, 0,
        0, 0, 0, 0, 0, 0, 0, 0, 1, 1, 1, 1, 1, 1, 62, 1, 62, 1, 1, 1, 1, 1, 1, 0, 0, 0, 0, 0, 0, 0, 0, 0,
        0, 0, 0, 0, 0, 0, 0, 0, 0, 0, 0, 0, 1, 0, 0, 1, 0, 0, 1, 0, 0, 0, 0, 0, 0, 0, 0, 0, 0, 0, 0, 0,
        0, 0, 0, 0, 0, 0, 0, 0, 0, 0, 0, 0, 1, 0, 100, 1, 100, 0, 1, 0, 0, 0, 0, 0, 0, 0, 0, 0, 0, 0, 0, 0,
        0, 0, 0, 0, 0, 0, 0, 0, 0, 0, 0, 0, 1, 0, 0, 1, 6300, 0, 1, 0, 0, 0, 0, 0, 0, 0, 0, 0, 0, 0, 0, 0,
        0, 0, 0, 0, 0, 0, 0, 0, 0, 0, 0, 0, 1, 1, 1, 1, 1, 1, 1, 0, 0, 0, 0, 0, 0, 0, 0, 0, 0, 0, 0, 0,
        0, 0, 0, 0, 0, 0, 0, 0, 0, 0, 0, 0, 0, 0, 0, 0, 0, 0, 0, 0, 0, 0, 0, 0, 0, 0, 0, 0, 0, 0, 0, 0,
        0, 0, 0, 0, 0, 0, 0, 0, 0, 0, 0, 0, 0, 0, 0, 0, 0, 0, 0, 0, 0, 0, 0, 0, 0, 0, 0, 0, 0, 0, 0, 0,
        0, 0, 0, 0, 0, 0, 0, 0, 0, 0, 0, 0, 0, 0, 0, 0, 0, 0, 0, 0, 0, 0, 0, 0, 0, 0, 0, 0, 0, 0, 0, 0,
        0, 0, 0, 0, 0, 0, 0, 0, 0, 0, 0, 0, 0, 0, 0, 0, 0, 0, 0, 0, 0, 0, 0, 0, 0, 0, 0, 0, 0, 0, 0, 0,
        0, 0, 0, 0, 0, 0, 0, 0, 0, 0, 0, 0, 0, 0, 0, 0, 0, 0, 0, 0, 0, 0, 0, 0, 0, 0, 0, 0, 0, 0, 0, 0,
        0, 0, 0, 0, 0, 0, 0, 0, 0, 0, 0, 0, 0, 0, 0, 0, 0, 0, 0, 0, 0, 0, 0, 0, 0, 0, 0, 0, 0, 0, 0, 0,
        0, 0, 0, 0, 0, 0, 0, 0, 0, 0, 0, 0, 0, 0, 0, 0, 0, 0, 0, 0, 0, 0, 0, 0, 0, 0, 0, 0, 0, 0, 0, 0,
        0, 0, 0, 0, 0, 0, 0, 0, 0, 0, 0, 0, 0, 0, 0, 0, 0, 0, 0, 0, 0, 0, 0, 0, 0, 0, 0, 0, 0, 0, 0, 0,
        0, 0, 0, 0, 0, 0, 0, 0, 0, 0, 0, 0, 0, 0, 0, 0, 0, 0, 0, 0, 0, 0, 0, 0, 0, 0, 0, 0, 0, 0, 0, 0,
        0, 0, 0, 0, 0, 0, 0, 0, 0, 0, 0, 0, 0, 0, 0, 0, 0, 0, 0, 0, 0, 0, 0, 0, 0, 0, 0, 0, 0, 0, 0, 0
      ]
    },
    "5" : {
      "name" : "Test 04",
      "password" : "OKAY",
      "time" : 999,
      "chips" : 0,
      "hint" : "2 invisible wall tiles: 1 and 3 spaces below this",
      "links" : {

      },
      "width" : 32,
      "board" : [
        3, 3, 3, 3, 3, 3, 3, 3, 3, 3, 3, 3, 3, 3, 3, 3, 3, 3, 3, 3, 3, 3, 3, 3, 3, 3, 3, 3, 3, 3, 3, 3,
        54, 12000000, 0, 0, 0, 0, 0, 0, 0, 0, 0, 0, 0, 0, 0, 0, 0, 0, 0, 0, 0, 0, 0, 0, 0, 0, 0, 0, 0, 0, 0, 0,
        54, 0, 0, 0, 0, 0, 0, 0, 3, 0, 0, 0, 0, 2, 0, 0, 0, 0, 0, 0, 0, 0, 0, 0, 0, 0, 0, 0, 0, 0, 0, 0,
        54, 41, 41, 41, 41, 0, 40, 0, 3, 0, 3, 3, 0, 2, 0, 2, 2, 0, 0, 0, 0, 0, 0, 0, 0, 0, 0, 0, 0, 0, 0, 0,
        54, 41, 41, 41, 41, 0, 54, 0, 0, 0, 0, 0, 0, 0, 0, 0, 0, 0, 0, 0, 0, 0, 0, 0, 0, 0, 0, 0, 0, 0, 0, 0,
        54, 41, 41, 41, 41, 0, 0, 0, 3, 0, 3, 3, 0, 2, 0, 2, 2, 0, 0, 0, 0, 0, 0, 0, 0, 0, 0, 0, 0, 0, 0, 0,
        54, 41, 41, 41, 41, 0, 54, 0, 3, 0, 0, 0, 0, 2, 0, 0, 0, 0, 0, 0, 0, 0, 0, 0, 0, 0, 0, 0, 0, 0, 0, 0,
        54, 7, 0, 0, 0, 0, 0, 0, 0, 0, 0, 0, 0, 0, 0, 0, 0, 0, 0, 0, 0, 0, 0, 0, 0, 0, 0, 0, 0, 0, 0, 0,
        54, 55, 55, 55, 55, 55, 55, 55, 55, 55, 55, 55, 55, 55, 55, 55, 55, 55, 55, 55, 55, 55, 55, 55, 55, 55, 55, 55, 55, 55, 55, 55
      ]
    },
    "6" : {
      "name" : "Test 05",
      "password" : "OYES",
      "time" : 500,
      "chips" : 2,
      "hint" : "Push blocks into water and bombs to make your way across",
      "links" : {

      },
      "width" : 18,
      "board" : [
        1, 1, 1, 1, 1, 1, 1, 1, 1, 1, 1, 1, 1, 1, 1, 1, 1, 1,
        1, 1000, 0, 0, 30, 30, 30, 0, 0, 0, 36, 36, 36, 0, 0, 6, 7, 1,
        1, 0, 0, 0, 30, 30, 30, 0, 0, 0, 36, 36, 36, 0, 0, 0, 6, 1,
        1, 0, 500000, 1100, 30, 30, 30, 0, 500000, 0, 36, 36, 36, 0, 0, 0, 0, 1,
        1, 13000000, 0, 0, 30, 100, 30, 0, 0, 0, 36, 100, 36, 0, 0, 0, 0, 1,
        1, 40, 500000, 1200, 30, 30, 30, 0, 500000, 0, 36, 36, 36, 0, 0, 0, 0, 1,
        1, 0, 0, 0, 30, 30, 30, 0, 0, 0, 36, 36, 36, 0, 0, 0, 0, 1,
        1, 0, 0, 0, 30, 30, 30, 0, 0, 0, 36, 36, 36, 0, 0, 0, 0, 1,
        1, 1, 1, 1, 1, 1, 1, 1, 1, 1, 1, 1, 1, 1, 1, 1, 1, 1
      ]
    },
    "7" : {
      "name" : "Toggle Boggle",
      "password" : "TOGG",
      "time" : 999,
      "chips" : 4,
      "hint" : "Let's get freaky with toggle walls",
      "links" : {

      },
      "width" : 13,
      "board" : [
        1, 1, 1, 1, 1, 1, 1, 1, 1, 1, 1, 1, 1,
        1, 10000000, 0, 1, 50, 100, 1, 0, 100, 1, 0, 100, 1,
        1, 40, 50, 70, 0, 0, 1, 50, 0, 71, 0, 0, 1,
        1, 1, 1, 1, 1, 71, 1, 1, 70, 1, 1, 1, 1,
        1, 100, 0, 1, 0, 0, 1, 0, 0, 1, 0, 0, 1,
        1, 50, 0, 70, 50, 0, 71, 0, 50, 1, 0, 0, 1,
        1, 70, 1, 1, 1, 1, 1, 1, 1, 1, 1, 1, 1,
        1, 0, 0, 0, 0, 0, 0, 0, 0, 0, 0, 0, 1,
        1, 0, 0, 0, 0, 0, 0, 0, 0, 0, 0, 0, 1,
        1, 1, 6, 1, 1, 1, 1, 1, 1, 1, 1, 1, 1,
        1, 0, 0, 1, 0, 0, 1, 0, 0, 1, 0, 0, 1,
        1, 7, 0, 1, 0, 0, 1, 0, 0, 1, 0, 0, 1,
        1, 1, 1, 1, 1, 1, 1, 1, 1, 1, 1, 1, 1,
        1, 0, 0, 1, 0, 0, 1, 0, 0, 1, 0, 0, 1,
        1, 0, 0, 1, 0, 0, 1, 0, 0, 1, 0, 0, 1,
        1, 1, 1, 1, 1, 1, 1, 1, 1, 1, 1, 1, 1
      ]
    },
    "8" : {
      "name" : "Slide Reel",
      "password" : "SLID",
      "time" : 250,
      "chips" : 1,
      "hint" : "Ice to meet you :O",
      "links" : {

      },
      "width" : 9,
      "board" : [
        1, 1, 1, 1, 1, 1, 1, 1, 1,
        1, 25, 32, 32, 34, 32, 32, 24, 1,
        1, 32, 1200, 0, 0, 0, 0, 32, 1,
        1, 32, 0, 32, 32, 32, 0, 32, 1,
        7, 34, 0, 32, 12000000, 32, 0, 34, 1,
        1, 32, 0, 32, 32, 32, 0, 32, 1,
        1, 32, 0, 0, 40, 0, 0, 32, 1,
        1, 26, 32, 32, 34, 32, 32, 27, 1,
        1, 1, 1, 1, 1, 1, 1, 1, 1
      ]
    }
  }
}