{
  "Test": {
    "meta" : {
      "name" : "Test",
      "author" : "DolphInspired",
      "created" : "01/25/2016 11:22:33.444",
      "modified" : "01/25/2016 11:22:33.444",
      "size" : 10
    },
    "1" : {
      "name" : "Wow this actually works",
      "password" : "AAAA",
      "time" : 0,
      "chips" : 0,
      "hint" : "First functional level created. Tests drawing and simple collision. The teleports came MUCH later...",
      "links" : {

      },
      "width" : 9,
      "board" : [
        1, 1, 1, 1, 1, 1, 1, 1, 1,
        1, 6300, 0, 0, 0, 0, 0, 0, 1,
        1, 0, 42, 0, 0, 0, 42, 0, 1,
        1, 0, 0, 0, 0, 0, 0, 0, 1,
        1, 0, 0, 0, 12000000, 0, 0, 0, 1,
        1, 0, 0, 0, 0, 0, 0, 0, 1,
        1, 0, 42, 0, 40, 0, 42, 0, 1,
        1, 0, 0, 0, 0, 0, 0, 70, 1,
        1, 1, 1, 1, 1, 1, 1, 1, 1
      ]
    },
    "2" : {
      "name" : "Testing grounds",
      "password" : "DBCA",
      "time" : 120,
      "chips" : 12,
      "hint" : "This level tests lots of things, including level scrolling. Some things don't work yet...",
      "links" : {

      },
      "width" : 12,
      "board" : [
        1, 1, 1, 1, 1, 1, 1, 1, 1, 1, 1, 1,
        1, 12000000, 6300, 6300, 63, 63, 0, 0, 0, 0, 0, 1,
        1, 0, 0, 0, 0, 0, 0, 0, 0, 1100, 31, 1,
        1, 40, 6000, 6000, 60, 60, 0, 0, 0, 0, 0, 1,
        1, 0, 0, 0, 0, 35, 0, 0, 0, 1000, 30, 1,
        1, 0, 6100, 6100, 61, 61, 0, 0, 0, 0, 0, 1,
        1, 0, 0, 0, 0, 45, 0, 0, 0, 1300, 20, 1,
        1, 0, 6200, 6200, 62, 62, 0, 0, 0, 0, 0, 1,
        1, 0, 0, 0, 0, 0, 0, 0, 0, 1200, 32, 1,
        1, 100, 100, 100, 100, 100, 100, 100, 100, 100, 5, 1,
        1, 420000, 100, 100, 100, 100, 100, 100, 100, 5, 70, 1,
        1, 1, 1, 1, 1, 1, 1, 1, 1, 1, 1, 1
      ]
    },
    "3" : {
      "name" : "Thinwall Jackson",
      "password" : "ABCD",
      "time" : 0,
      "chips" : 0,
      "hint" : "Thin wall collision test. Could you tell?",
      "links" : {

      },
      "width" : 9,
      "board" : [
        1, 1, 1, 1, 1, 1, 1, 1, 1,
        1, 70, 0, 0, 0, 0, 0, 40, 1,
        1, 0, 0, 0, 0, 0, 0, 0, 1,
        1, 0, 0, 15, 10, 14, 0, 0, 1,
        1, 0, 0, 11, 12000000, 0, 13, 0, 1,
        1, 0, 0, 16, 12, 17, 0, 0, 1,
        1, 0, 0, 0, 0, 0, 300000, 0, 1,
        1, 0, 0, 310000, 0, 0, 0, 0, 1,
        1, 1, 1, 1, 1, 1, 1, 1, 1
      ]
    },
    "4" : {
      "name" : "LESSON 1",
      "password" : "BDHP",
      "time" : 100,
      "chips" : 11,
      "hint" : "Hint: collect chips to get past the chip socket. Use keys to open doors.",
      "links" : {

      },
      "width" : 32,
      "board" : [
        0, 0, 0, 0, 0, 0, 0, 0, 0, 0, 0, 0, 0, 0, 0, 0, 0, 0, 0, 0, 0, 0, 0, 0, 0, 0, 0, 0, 0, 0, 0, 0,
        0, 0, 0, 0, 0, 0, 0, 0, 0, 0, 0, 0, 0, 0, 0, 0, 0, 0, 0, 0, 0, 0, 0, 0, 0, 0, 0, 0, 0, 0, 0, 0,
        0, 0, 0, 0, 0, 0, 0, 0, 0, 0, 0, 0, 0, 0, 0, 0, 0, 0, 0, 0, 0, 0, 0, 0, 0, 0, 0, 0, 0, 0, 0, 0,
        0, 0, 0, 0, 0, 0, 0, 0, 0, 0, 0, 0, 0, 0, 0, 0, 0, 0, 0, 0, 0, 0, 0, 0, 0, 0, 0, 0, 0, 0, 0, 0,
        0, 0, 0, 0, 0, 0, 0, 0, 0, 0, 0, 0, 0, 0, 0, 0, 0, 0, 0, 0, 0, 0, 0, 0, 0, 0, 0, 0, 0, 0, 0, 0,
        0, 0, 0, 0, 0, 0, 0, 0, 0, 0, 0, 0, 0, 0, 0, 0, 0, 0, 0, 0, 0, 0, 0, 0, 0, 0, 0, 0, 0, 0, 0, 0,
        0, 0, 0, 0, 0, 0, 0, 0, 0, 0, 0, 0, 0, 0, 0, 0, 0, 0, 0, 0, 0, 0, 0, 0, 0, 0, 0, 0, 0, 0, 0, 0,
        0, 0, 0, 0, 0, 0, 0, 0, 0, 0, 0, 0, 0, 0, 0, 0, 0, 0, 0, 0, 0, 0, 0, 0, 0, 0, 0, 0, 0, 0, 0, 0,
        0, 0, 0, 0, 0, 0, 0, 0, 0, 0, 1, 1, 1, 1, 1, 0, 1, 1, 1, 1, 1, 0, 0, 0, 0, 0, 0, 0, 0, 0, 0, 0,
        0, 0, 0, 0, 0, 0, 0, 0, 0, 0, 1, 0, 0, 0, 1, 1, 1, 0, 0, 0, 1, 0, 0, 0, 0, 0, 0, 0, 0, 0, 0, 0,
        0, 0, 0, 0, 0, 0, 0, 0, 0, 0, 1, 0, 100, 0, 1, 70, 1, 0, 100, 0, 1, 0, 0, 0, 0, 0, 0, 0, 0, 0, 0, 0,
        0, 0, 0, 0, 0, 0, 0, 0, 1, 1, 1, 1, 1, 63, 1, 5, 1, 63, 1, 1, 1, 1, 1, 0, 0, 0, 0, 0, 0, 0, 0, 0,
        0, 0, 0, 0, 0, 0, 0, 0, 1, 0, 6200, 0, 60, 0, 0, 0, 0, 0, 61, 0, 6200, 0, 1, 0, 0, 0, 0, 0, 0, 0, 0, 0,
        0, 0, 0, 0, 0, 0, 0, 0, 1, 0, 100, 0, 1, 6000, 0, 40, 0, 6100, 1, 0, 100, 0, 1, 0, 0, 0, 0, 0, 0, 0, 0, 0,
        0, 0, 0, 0, 0, 0, 0, 0, 1, 1, 1, 1, 1, 100, 0, 12000000, 0, 100, 1, 1, 1, 1, 1, 0, 0, 0, 0, 0, 0, 0, 0, 0,
        0, 0, 0, 0, 0, 0, 0, 0, 1, 0, 100, 0, 1, 6000, 0, 0, 0, 6100, 1, 0, 100, 0, 1, 0, 0, 0, 0, 0, 0, 0, 0, 0,
        0, 0, 0, 0, 0, 0, 0, 0, 1, 0, 0, 0, 61, 0, 0, 100, 0, 0, 60, 0, 0, 0, 1, 0, 0, 0, 0, 0, 0, 0, 0, 0,
        0, 0, 0, 0, 0, 0, 0, 0, 1, 1, 1, 1, 1, 1, 62, 1, 62, 1, 1, 1, 1, 1, 1, 0, 0, 0, 0, 0, 0, 0, 0, 0,
        0, 0, 0, 0, 0, 0, 0, 0, 0, 0, 0, 0, 1, 0, 0, 1, 0, 0, 1, 0, 0, 0, 0, 0, 0, 0, 0, 0, 0, 0, 0, 0,
        0, 0, 0, 0, 0, 0, 0, 0, 0, 0, 0, 0, 1, 0, 100, 1, 100, 0, 1, 0, 0, 0, 0, 0, 0, 0, 0, 0, 0, 0, 0, 0,
        0, 0, 0, 0, 0, 0, 0, 0, 0, 0, 0, 0, 1, 0, 0, 1, 6300, 0, 1, 0, 0, 0, 0, 0, 0, 0, 0, 0, 0, 0, 0, 0,
        0, 0, 0, 0, 0, 0, 0, 0, 0, 0, 0, 0, 1, 1, 1, 1, 1, 1, 1, 0, 0, 0, 0, 0, 0, 0, 0, 0, 0, 0, 0, 0,
        0, 0, 0, 0, 0, 0, 0, 0, 0, 0, 0, 0, 0, 0, 0, 0, 0, 0, 0, 0, 0, 0, 0, 0, 0, 0, 0, 0, 0, 0, 0, 0,
        0, 0, 0, 0, 0, 0, 0, 0, 0, 0, 0, 0, 0, 0, 0, 0, 0, 0, 0, 0, 0, 0, 0, 0, 0, 0, 0, 0, 0, 0, 0, 0,
        0, 0, 0, 0, 0, 0, 0, 0, 0, 0, 0, 0, 0, 0, 0, 0, 0, 0, 0, 0, 0, 0, 0, 0, 0, 0, 0, 0, 0, 0, 0, 0,
        0, 0, 0, 0, 0, 0, 0, 0, 0, 0, 0, 0, 0, 0, 0, 0, 0, 0, 0, 0, 0, 0, 0, 0, 0, 0, 0, 0, 0, 0, 0, 0,
        0, 0, 0, 0, 0, 0, 0, 0, 0, 0, 0, 0, 0, 0, 0, 0, 0, 0, 0, 0, 0, 0, 0, 0, 0, 0, 0, 0, 0, 0, 0, 0,
        0, 0, 0, 0, 0, 0, 0, 0, 0, 0, 0, 0, 0, 0, 0, 0, 0, 0, 0, 0, 0, 0, 0, 0, 0, 0, 0, 0, 0, 0, 0, 0,
        0, 0, 0, 0, 0, 0, 0, 0, 0, 0, 0, 0, 0, 0, 0, 0, 0, 0, 0, 0, 0, 0, 0, 0, 0, 0, 0, 0, 0, 0, 0, 0,
        0, 0, 0, 0, 0, 0, 0, 0, 0, 0, 0, 0, 0, 0, 0, 0, 0, 0, 0, 0, 0, 0, 0, 0, 0, 0, 0, 0, 0, 0, 0, 0,
        0, 0, 0, 0, 0, 0, 0, 0, 0, 0, 0, 0, 0, 0, 0, 0, 0, 0, 0, 0, 0, 0, 0, 0, 0, 0, 0, 0, 0, 0, 0, 0,
        0, 0, 0, 0, 0, 0, 0, 0, 0, 0, 0, 0, 0, 0, 0, 0, 0, 0, 0, 0, 0, 0, 0, 0, 0, 0, 0, 0, 0, 0, 0, 0
      ]
    },
    "5" : {
      "name" : "mstank32.dll",
      "password" : "OKAY",
      "time" : 999,
      "chips" : 1,
      "hint" : "Wow, this level is asymmetrical. Neat.",
      "links" : {

      },
      "width" : 32,
      "board" : [
        3, 3, 3, 3, 3, 3, 3, 3, 3, 3, 3, 3, 3, 3, 3, 3, 3, 3, 3, 3, 3, 3, 3, 3, 3, 3, 3, 3, 3, 3, 3, 3,
        7, 12000000, 0, 0, 0, 41, 0, 0, 0, 0, 0, 0, 3, 0, 0, 0, 0, 0, 0, 0, 0, 0, 0, 0, 0, 0, 0, 0, 0, 0, 0, 3,
        7, 52, 0, 0, 0, 1, 34, 34, 34, 34, 34, 34, 3, 0, 0, 0, 0, 0, 0, 41, 0, 0, 0, 0, 0, 0, 0, 0, 0, 0, 0, 3,
        7, 0, 0, 0, 0, 1, 0, 0, 0, 0, 0, 0, 3, 0, 0, 0, 0, 0, 0, 0, 41, 0, 0, 0, 0, 0, 0, 0, 0, 0, 0, 3,
        7, 0, 0, 0, 50000, 1, 0, 0, 0, 0, 0, 0, 3, 0, 0, 41, 41, 41, 41, 41, 41, 41, 0, 0, 0, 0, 0, 0, 40, 0, 0, 3,
        7, 70000, 0, 0, 0, 1, 0, 0, 0, 0, 0, 0, 3, 0, 0, 0, 0, 0, 0, 0, 41, 0, 0, 0, 0, 0, 0, 0, 0, 0, 0, 3,
        7, 0, 0, 0, 50000, 1, 400000, 0, 0, 0, 0, 0, 3, 0, 0, 0, 0, 0, 0, 41, 0, 0, 0, 0, 0, 0, 0, 0, 0, 0, 0, 3,
        5, 70000, 0, 0, 0, 41, 100, 0, 0, 0, 0, 0, 2, 0, 0, 0, 0, 0, 0, 0, 0, 0, 0, 0, 0, 0, 0, 0, 0, 0, 0, 3,
        70, 3, 3, 3, 3, 3, 3, 3, 3, 3, 3, 3, 3, 3, 3, 3, 3, 3, 3, 3, 3, 3, 3, 3, 3, 3, 3, 3, 3, 3, 3, 3
      ]
    },
    "6" : {
      "name" : "Blockworthy Behavior",
      "password" : "OYES",
      "time" : 500,
      "chips" : 2,
      "hint" : "Push blocks into water and bombs to make your way across",
      "links" : {

      },
      "width" : 18,
      "board" : [
        1, 1, 1, 1, 1, 1, 1, 1, 1, 1, 1, 1, 1, 1, 1, 1, 1, 1,
        1, 1000, 0, 0, 30, 30, 30, 0, 0, 0, 36, 36, 36, 0, 0, 5, 70, 1,
        1, 0, 0, 0, 30, 30, 30, 0, 0, 0, 36, 36, 36, 0, 0, 0, 5, 1,
        1, 0, 500000, 1100, 30, 30, 30, 0, 500000, 0, 36, 36, 36, 0, 0, 0, 0, 1,
        1, 13000000, 0, 0, 30, 100, 30, 0, 0, 0, 36, 100, 36, 0, 0, 0, 0, 1,
        1, 40, 500000, 1200, 30, 30, 30, 0, 500000, 0, 36, 36, 36, 0, 0, 0, 0, 1,
        1, 0, 0, 0, 30, 30, 30, 0, 0, 0, 36, 36, 36, 0, 0, 0, 0, 1,
        1, 0, 0, 0, 30, 30, 30, 0, 0, 0, 36, 36, 36, 0, 0, 0, 0, 1,
        1, 1, 1, 1, 1, 1, 1, 1, 1, 1, 1, 1, 1, 1, 1, 1, 1, 1
      ]
    },
    "7" : {
      "name" : "Toggle Boggle",
      "password" : "TOGG",
      "time" : 999,
      "chips" : 4,
      "hint" : "Let's get freaky with toggle walls",
      "links" : {

      },
      "width" : 13,
      "board" : [
        1, 1, 1, 1, 1, 1, 1, 1, 1, 1, 1, 1, 1,
        1, 10000000, 0, 1, 50, 100, 1, 0, 100, 1, 0, 100, 1,
        1, 40, 50, 64, 0, 0, 1, 50, 0, 65, 0, 0, 1,
        1, 1, 1, 1, 1, 65, 1, 1, 64, 1, 1, 1, 1,
        1, 100, 0, 1, 0, 0, 1, 0, 0, 1, 0, 0, 1,
        1, 50, 0, 64, 50, 0, 65, 0, 50, 1, 0, 0, 1,
        1, 64, 1, 1, 1, 1, 1, 1, 1, 1, 1, 1, 1,
        1, 0, 0, 0, 0, 0, 0, 0, 0, 0, 0, 0, 1,
        1, 0, 0, 0, 0, 0, 0, 0, 0, 0, 0, 0, 1,
        1, 1, 5, 1, 1, 1, 1, 1, 1, 1, 1, 1, 1,
        1, 0, 0, 1, 0, 0, 1, 0, 0, 1, 0, 0, 1,
        1, 70, 0, 1, 0, 0, 1, 0, 0, 1, 0, 0, 1,
        1, 1, 1, 1, 1, 1, 1, 1, 1, 1, 1, 1, 1,
        1, 0, 0, 1, 0, 0, 1, 0, 0, 1, 0, 0, 1,
        1, 0, 0, 1, 0, 0, 1, 0, 0, 1, 0, 0, 1,
        1, 1, 1, 1, 1, 1, 1, 1, 1, 1, 1, 1, 1
      ]
    },
    "8" : {
      "name" : "Slide Reel",
      "password" : "SLID",
      "time" : 250,
      "chips" : 1,
      "hint" : "Ice to meet you :O",
      "links" : {

      },
      "width" : 9,
      "board" : [
        1, 1, 1, 1, 1, 1, 1, 1, 1,
        1, 25, 32, 32, 34, 32, 32, 24, 1,
        1, 32, 1200, 0, 0, 0, 0, 32, 1,
        1, 32, 0, 32, 32, 32, 0, 32, 1,
        70, 34, 0, 32, 12000000, 32, 0, 34, 1,
        1, 32, 0, 32, 32, 32, 0, 32, 1,
        1, 32, 0, 0, 40, 0, 0, 32, 1,
        1, 26, 32, 32, 34, 32, 32, 27, 1,
        1, 1, 1, 1, 1, 1, 1, 1, 1
      ]
    },
    "9" : {
      "name" : "Debuggerator",
      "password" : "BUGS",
      "time" : 400,
      "chips" : 4,
      "hint" : "Monsters have feelings too. Try redirecting their feelings with blocks.",
      "links" : {

      },
      "width" : 18,
      "board" : [
        1, 1, 1, 1, 1, 1, 1, 1, 1, 1, 1, 1, 1, 1, 1, 1, 1, 1,
        1, 0, 0, 0, 0, 0, 0, 34, 1, 70, 1, 34, 0, 0, 0, 0, 0, 0,
        1, 0, 30, 0, 240000, 31, 0, 34, 1, 5, 1, 34, 0, 31, 0, 200000, 30, 0,
        1, 0, 0, 100, 0, 0, 0, 34, 0, 12000000, 0, 34, 0, 0, 100, 0, 0, 0,
        1, 0, 0, 0, 0, 0, 0, 34, 0, 0, 0, 34, 0, 0, 0, 220000, 0, 0,
        1, 0, 31, 0, 260000, 30, 0, 34, 0, 0, 0, 34, 0, 30, 0, 0, 31, 0,
        1, 0, 0, 0, 0, 0, 0, 34, 0, 0, 0, 34, 0, 0, 0, 0, 0, 0,
        1, 34, 34, 34, 34, 34, 34, 34, 0, 0, 0, 34, 34, 34, 34, 34, 34, 34,
        1, 0, 0, 0, 0, 0, 0, 0, 0, 0, 0, 0, 0, 0, 0, 0, 0, 0,
        1, 0, 500000, 0, 500000, 0, 500000, 0, 0, 40, 0, 0, 500000, 0, 500000, 0, 500000, 0,
        1, 0, 0, 0, 0, 0, 0, 0, 0, 0, 0, 0, 0, 0, 0, 0, 0, 0,
        1, 34, 34, 34, 34, 34, 34, 34, 0, 0, 0, 34, 34, 34, 34, 34, 34, 34,
        1, 0, 130000, 0, 0, 0, 0, 34, 0, 0, 0, 34, 0, 0, 0, 0, 150000, 0,
        1, 0, 31, 0, 0, 30, 120000, 34, 0, 0, 0, 34, 170000, 30, 0, 0, 31, 0,
        1, 0, 0, 100, 0, 0, 0, 34, 0, 0, 0, 34, 0, 0, 0, 100, 0, 0,
        1, 100000, 0, 0, 0, 0, 0, 34, 0, 0, 0, 34, 0, 0, 0, 0, 0, 140000,
        1, 0, 0, 0, 0, 110000, 0, 34, 0, 0, 0, 34, 0, 160000, 0, 0, 0, 0,
        1, 1, 1, 1, 1, 1, 1, 1, 1, 1, 1, 1, 1, 1, 1, 1, 1, 1
      ]
    },
    "10" : {
      "name" : "Of Blobs and Men",
      "password" : "BUGS",
      "time" : 0,
      "chips" : 4,
      "hint" : "These monsters have absolutely no sense of direction",
      "links" : {

      },
      "width" : 9,
      "board" : [
          1, 1, 1, 1, 1, 1, 1, 1, 1,
          1, 12000000, 0, 0, 0, 0, 0, 40, 1,
          1, 41, 41, 500041, 41, 500041, 41, 41, 1,
          1, 100, 0, 0, 0, 0, 0, 100, 1,
          1, 0, 0, 0, 0, 0, 0, 0, 1,
          1, 0, 0, 340000, 0, 0, 440000, 0, 1,
          1, 0, 0, 0, 0, 0, 0, 0, 1,
          1, 100, 0, 0, 0, 0, 0, 100, 5,
          1, 1, 1, 1, 1, 1, 1, 1, 70
      ]
    }
  }
}